18 18 18 18 18 18 18 24 16 16 16 16 16 16 16 16 32 32 32 32 32 32 32 32 32 32 32 32 32 32 32 16 16 16 16 16 16 16 16 16 23 21 21 21 21 21 21 21 21 21 
18 18 19 19 18 18 18 24 16 16 16 16 16 16 16 16 32 17 17 17 17 17 17 17 17 17 17 17 17 17 32 16 16 16 16 16 16 16 16 16 23 18 18 18 18 18 18 18 18 18 
18 18 18 18 18 18 18 24 16 16 16 16 16 16 16 16 32 17 17 17 17 17 17 17 17 17 17 17 17 17 32 16 16 16 16 16 16 16 16 16 23 18 18 18 19 18 18 18 18 18 
18 18 18 18 18 18 18 24 16 16 16 16 16 16 16 16 32 17 17 17 17 17 17 17 17 17 17 17 17 17 32 16 16 16 16 16 16 16 16 16 23 19 18 18 18 18 18 18 18 18 
18 18 18 18 18 18 18 24 16 16 16 16 16 16 16 16 32 17 17 17 17 17 17 17 17 17 17 17 17 17 32 16 16 16 16 16 16 16 16 16 23 18 18 18 18 18 18 18 18 18 
18 19 18 18 18 18 18 24 16 16 16 16 16 16 16 16 32 17 17 17 17 17 17 17 17 17 17 17 17 17 32 16 16 16 16 16 16 16 16 16 23 18 18 18 18 18 18 18 19 18 
18 18 18 18 18 19 18 24 16 16 16 16 16 16 16 16 32 32 32 32 32 32 32 17 32 32 32 32 32 32 32 16 16 16 16 16 16 16 16 16 23 18 18 18 18 18 18 18 18 18 
18 18 18 18 18 19 18 24 16 16 16 16 16 16 16 16 16 16 16 16 16 8 3 3 3 7 16 16 16 16 16 16 16 16 16 16 16 16 16 16 23 18 18 19 18 18 18 18 18 18 
18 19 18 18 18 18 18 24 16 16 16 16 16 16 16 16 16 16 16 16 16 8 3 3 3 7 16 16 16 16 16 16 16 16 16 16 16 16 16 16 23 18 18 18 18 18 18 18 18 18 
18 18 18 18 18 18 28 27 16 16 16 16 16 16 16 16 16 16 16 16 16 8 3 3 3 7 16 16 16 16 16 16 16 16 16 16 16 16 16 16 23 18 18 18 18 18 18 18 19 18 
18 18 18 18 18 18 24 1 2 1 1 2 1 1 1 2 1 1 1 1 1 8 3 3 3 7 1 1 1 1 1 1 1 1 1 1 1 1 1 1 23 18 18 18 18 18 18 18 18 18 
18 18 18 19 18 18 30 21 21 21 21 21 21 21 21 21 21 21 21 21 21 21 3 3 3 21 21 21 21 21 21 21 21 21 21 21 21 21 21 21 31 18 18 19 18 18 18 18 18 18 
18 18 18 18 18 18 28 26 26 26 26 26 26 26 26 26 26 26 26 26 26 26 3 3 3 26 26 26 26 26 26 26 26 26 26 26 26 26 26 26 29 18 18 18 18 18 18 18 18 18 
18 18 18 18 18 18 24 1 16 16 16 16 16 16 16 16 16 16 16 16 16 8 3 3 3 7 16 16 16 16 16 16 16 16 16 16 16 16 16 16 23 18 18 18 18 18 18 18 18 18 
18 19 18 18 18 18 24 1 16 16 16 16 16 16 16 16 16 16 16 16 16 8 3 3 3 7 16 16 16 16 16 16 16 16 16 16 16 16 16 16 23 18 18 18 18 18 18 18 18 18 
18 18 18 18 18 18 30 22 16 16 16 16 16 16 16 16 16 16 16 16 16 8 3 3 3 7 16 16 16 16 16 32 32 32 32 32 16 16 16 16 23 18 18 18 18 18 19 18 18 18 
18 18 19 18 18 18 18 24 16 16 2 2 2 2 2 2 2 16 16 16 16 8 3 3 3 7 16 16 16 16 16 32 17 36 17 32 16 16 16 16 23 18 19 18 18 18 18 18 18 18 
18 18 18 18 18 19 18 24 16 16 2 12 33 10 33 13 2 16 16 16 16 8 3 3 3 7 16 16 16 16 16 32 17 17 17 32 16 16 16 16 23 18 18 18 18 18 18 18 18 18 
18 18 18 18 18 18 18 24 16 16 2 8 3 3 3 7 2 16 16 16 16 8 3 3 3 7 16 16 16 16 16 32 17 17 17 32 16 16 16 16 23 18 18 18 18 18 18 18 19 18 
18 18 18 18 18 18 18 24 16 16 2 14 6 3 4 15 2 16 16 16 16 8 3 3 3 7 16 16 16 16 16 32 32 17 32 32 16 16 16 16 23 18 18 18 18 18 18 18 18 18 
19 18 18 18 19 18 18 24 16 16 16 16 8 3 7 16 16 16 16 16 16 8 3 3 3 7 16 16 16 16 16 16 12 10 13 16 16 16 16 16 23 18 19 18 18 18 18 18 18 18 
18 18 18 18 18 18 18 24 16 16 16 16 8 3 7 16 16 16 16 16 16 8 3 3 3 7 16 16 16 16 16 16 8 3 7 16 16 16 16 16 23 18 18 18 18 18 18 19 18 18 
18 18 18 18 18 18 18 24 10 10 10 10 11 3 9 10 10 10 10 10 10 11 3 3 3 9 10 10 10 13 16 12 11 3 9 10 10 10 10 13 23 18 18 18 19 18 18 18 18 18 
18 18 18 18 18 19 18 24 3 3 3 3 3 3 3 3 3 3 3 3 3 3 3 3 3 3 3 3 3 7 1 8 3 3 3 3 3 3 3 7 23 18 18 18 18 18 18 18 18 18 
18 18 18 18 18 18 18 24 3 3 3 3 3 3 3 3 3 3 3 3 3 3 3 3 3 3 3 3 3 7 1 8 3 3 3 3 3 3 3 7 23 18 19 18 18 18 18 18 19 18 
18 18 18 18 18 18 19 24 5 5 5 5 5 5 5 5 5 5 5 5 5 6 3 3 3 4 5 5 5 15 16 14 5 5 5 5 5 5 5 15 23 18 18 18 18 18 18 18 18 18 
18 18 18 18 18 18 18 24 16 16 16 16 16 16 16 16 16 16 16 16 16 8 3 3 3 7 16 16 16 16 16 16 16 16 16 16 16 16 16 16 23 18 18 18 18 18 18 18 18 18 
18 18 19 18 18 18 18 24 16 16 16 16 16 16 16 16 16 16 16 16 16 8 3 3 3 7 16 16 16 16 16 16 16 16 16 16 16 16 16 16 23 18 18 18 18 19 18 18 18 18 
18 18 18 18 18 18 18 24 16 16 16 16 16 16 16 16 16 16 16 16 16 8 3 3 3 7 16 16 16 16 16 16 16 16 16 16 16 16 16 16 23 18 18 18 18 18 18 18 19 18 
18 18 18 18 18 18 18 24 16 16 16 16 16 16 16 16 16 16 16 16 16 8 3 3 3 7 16 16 16 16 16 16 16 16 16 16 16 16 16 16 23 18 18 18 18 19 18 18 18 18 
18 18 18 18 18 19 18 24 16 16 16 16 16 16 16 16 16 16 16 16 16 8 3 3 3 7 16 16 16 16 16 16 16 16 16 16 16 16 16 16 23 18 19 18 18 18 18 18 18 18 
18 18 18 18 18 28 26 27 16 16 16 16 16 16 1 1 2 2 2 2 2 8 3 3 3 7 2 1 2 2 2 2 16 16 16 16 16 16 16 16 23 18 18 18 18 18 18 18 18 18 
19 18 18 28 26 27 16 16 16 16 16 16 16 16 1 1 2 2 33 2 33 8 3 3 3 7 1 33 2 1 33 2 16 16 16 16 16 16 16 16 23 18 18 18 18 18 18 18 18 18 
18 18 19 24 16 16 16 16 16 16 16 16 16 16 1 1 12 10 10 10 10 11 3 3 3 9 10 10 10 10 10 10 10 10 10 10 10 10 10 13 23 18 18 18 18 19 18 18 18 18 
18 18 18 24 16 16 16 16 16 16 16 16 16 16 1 33 8 3 3 3 3 3 3 3 3 3 3 3 3 3 3 3 3 3 3 3 3 3 3 7 23 18 18 19 19 18 18 18 18 18 
18 18 18 24 16 16 16 16 16 16 16 16 16 16 1 1 8 3 3 3 3 3 3 3 3 3 3 3 3 3 3 3 3 3 3 3 3 3 3 7 23 18 18 18 18 18 18 18 18 18 
18 18 18 24 16 16 16 16 16 16 16 16 16 16 2 2 8 3 3 3 3 3 3 3 3 3 3 3 3 3 3 4 5 5 5 5 5 5 5 15 23 18 18 18 18 18 18 18 19 18 
18 18 18 24 2 2 2 2 16 16 16 16 16 16 1 2 8 3 3 4 5 5 5 5 5 5 5 6 3 3 4 15 1 16 16 16 2 16 16 16 23 18 18 18 18 18 18 18 18 18 
19 18 18 24 2 2 2 2 16 16 16 16 16 16 2 33 8 3 3 7 20 21 21 21 21 21 22 8 3 3 7 2 2 16 16 2 2 2 16 16 23 18 18 18 18 19 18 18 18 18 
18 18 18 24 2 2 2 2 16 16 16 16 16 16 2 2 8 3 3 7 23 18 18 18 18 18 24 8 3 3 7 33 1 16 16 2 2 2 16 16 23 19 18 18 18 18 18 18 18 18 
18 18 18 30 21 21 22 2 1 16 16 16 16 16 2 2 8 3 3 7 23 18 18 18 18 18 24 8 3 3 7 2 2 16 16 2 2 2 16 16 23 18 18 18 18 18 18 18 18 18 
18 18 18 18 18 18 30 22 2 2 2 2 2 2 2 1 14 5 5 15 23 18 18 18 18 18 24 14 5 5 15 1 2 16 16 2 2 2 16 16 23 18 18 18 18 18 18 18 18 18 
18 18 18 18 18 18 18 24 1 2 20 21 21 21 22 2 16 2 2 16 23 18 18 18 18 18 24 16 2 2 16 2 2 16 16 16 16 16 16 16 23 18 18 18 18 19 18 18 18 18 
18 19 18 18 18 18 19 30 21 21 31 18 18 18 30 21 21 21 21 21 31 18 18 18 18 18 30 21 21 21 21 22 1 1 1 1 1 1 1 1 23 18 19 18 18 18 18 18 18 18 
18 18 18 18 18 18 18 18 18 18 18 18 18 18 18 18 18 18 18 18 18 18 18 18 18 18 18 18 18 18 18 30 21 21 21 21 21 21 21 21 31 18 19 18 18 18 18 18 18 18 
18 18 18 18 18 18 18 18 19 18 18 18 18 18 18 18 18 18 18 18 18 18 18 18 18 18 18 18 18 19 18 18 18 18 18 18 18 18 18 18 18 18 18 18 18 18 19 18 18 18 
18 18 18 18 19 18 18 18 18 18 18 19 18 18 18 18 18 18 18 18 18 19 18 18 18 18 18 18 18 18 18 18 18 18 18 19 18 18 18 18 18 18 19 18 18 18 18 18 18 18 
18 18 18 18 18 18 18 18 18 18 18 18 18 18 18 18 18 18 18 18 18 18 18 18 18 18 18 18 18 18 18 18 18 18 18 18 18 18 18 18 18 18 18 18 18 18 18 18 18 18 
18 18 18 18 18 18 18 18 18 18 18 18 18 18 18 18 18 18 19 18 18 18 18 18 18 18 18 18 18 18 18 18 18 18 18 18 18 19 18 18 18 18 18 18 18 18 18 18 18 18 
18 18 18 18 18 18 18 19 18 18 18 18 18 18 18 19 18 18 18 18 18 18 18 18 18 18 19 18 18 18 18 18 18 19 18 18 18 18 18 18 18 18 18 19 18 18 18 18 18 19 
