21 21 21 21 21 21 21 27 19 19 19 19 19 19 19 19 20 0 0 0 0 0 0 0 0 0 0 0 0 0 20 19 19 19 19 19 19 19 19 19 26 21 21 21 21 21 21 21 21 21 
21 21 21 21 21 21 21 27 19 19 19 19 19 19 19 19 20 0 0 0 0 0 0 0 0 0 0 0 0 0 20 19 19 19 19 19 19 19 19 19 26 21 21 21 21 21 21 21 21 21 
21 21 21 21 21 21 21 27 19 19 19 19 19 19 19 19 20 0 0 0 0 0 0 0 0 0 0 0 0 0 20 19 19 19 19 19 19 19 19 19 26 21 21 21 21 21 21 21 21 21 
21 21 21 21 21 21 21 27 19 19 19 19 19 19 19 19 20 0 0 0 0 0 0 0 0 0 0 0 0 0 20 19 19 19 19 19 19 19 19 19 26 21 21 21 21 21 21 21 21 21 
21 21 21 21 21 21 21 27 19 19 19 19 19 19 19 19 20 0 0 0 0 0 0 0 0 0 0 0 0 0 20 19 19 19 19 19 19 19 19 19 26 21 21 21 21 21 21 21 21 21 
21 21 21 21 21 21 21 27 19 19 19 19 19 19 19 19 20 0 0 0 0 0 0 0 0 0 0 0 0 0 20 19 19 19 19 19 19 19 19 19 26 21 21 21 21 21 21 21 21 21 
21 21 21 21 21 21 21 27 19 19 19 19 19 19 19 19 20 20 20 20 20 20 0 0 0 20 20 20 20 20 20 19 19 19 19 19 19 19 19 19 26 21 21 21 21 21 21 21 21 21 
21 21 21 21 21 21 21 27 19 19 19 19 19 19 19 19 19 19 19 19 19 10 5 5 5 9 19 19 19 19 19 19 19 19 19 19 19 19 19 19 26 21 21 21 21 21 21 21 21 21 
21 21 21 21 21 21 21 27 19 19 19 19 19 19 19 19 19 19 19 19 19 10 5 5 5 9 19 19 19 19 19 19 19 19 19 19 19 19 19 19 26 21 21 21 21 21 21 21 21 21 
21 21 21 21 21 21 21 27 19 19 19 19 19 19 19 19 19 19 19 19 19 10 5 5 5 9 19 19 19 19 19 19 19 19 19 19 19 19 19 19 26 21 21 21 21 21 21 21 21 21 
21 21 21 21 21 21 21 33 24 24 24 24 24 24 24 24 24 24 24 24 24 24 5 5 5 24 24 24 24 24 24 24 24 24 24 24 24 24 24 24 34 21 21 21 21 21 21 21 21 21 
21 21 21 21 21 21 21 21 21 21 21 21 21 21 21 21 21 21 21 21 21 21 5 5 5 21 21 21 21 21 21 21 21 21 21 21 21 21 21 21 21 21 21 21 21 21 21 21 21 21 
21 21 21 21 21 21 21 31 29 29 29 29 29 29 29 29 29 29 29 29 29 29 5 5 5 29 29 29 29 29 29 29 29 29 29 29 29 29 29 29 32 21 21 21 21 21 21 21 21 21 
21 21 21 21 21 21 21 27 19 19 19 19 19 19 19 19 19 19 19 19 19 10 5 5 5 9 19 19 19 19 19 19 19 19 19 19 19 19 19 19 26 21 21 21 21 21 21 21 21 21 
21 21 21 21 21 21 31 30 19 19 19 19 19 19 19 19 19 19 19 19 19 10 5 5 5 9 19 19 19 19 19 19 19 19 19 19 19 19 19 19 26 21 21 21 21 21 21 21 21 21 
21 21 21 21 21 21 27 2 19 19 2 2 2 2 2 2 2 19 19 19 19 10 5 5 5 9 19 19 19 19 19 20 20 20 20 20 19 19 19 19 26 21 21 21 21 21 21 21 21 21 
21 21 21 21 21 21 27 2 19 19 2 2 2 2 2 2 2 19 19 19 19 10 5 5 5 9 19 19 19 19 19 20 0 0 0 20 19 19 19 19 26 21 21 21 21 21 21 21 21 21 
21 21 21 21 21 21 27 2 19 19 2 14 4 4 4 15 2 19 19 19 19 10 5 5 5 9 19 19 19 19 19 20 0 0 0 20 19 19 19 19 26 21 21 21 21 21 21 21 21 21 
21 21 21 21 21 21 33 25 19 19 2 10 5 5 5 9 2 19 19 19 19 10 5 5 5 9 19 19 19 19 19 20 0 0 0 20 19 19 19 19 26 21 21 21 21 21 21 21 21 21 
21 21 21 21 21 21 21 27 19 19 2 16 8 5 6 17 2 19 19 19 19 10 5 5 5 9 19 19 19 19 19 20 20 0 20 20 19 19 19 19 26 21 21 21 21 21 21 21 21 21 
21 21 21 21 21 21 21 27 19 19 19 19 10 5 9 19 19 19 19 19 19 10 5 5 5 9 19 19 19 19 19 19 10 5 9 19 19 19 19 19 26 21 21 21 21 21 21 21 21 21 
21 21 21 21 21 21 21 27 19 19 19 19 10 5 9 19 19 19 19 19 19 10 5 5 5 9 19 19 19 19 19 19 10 5 9 19 19 19 19 19 26 21 21 21 21 21 21 21 21 21 
21 21 21 21 21 21 21 27 14 12 12 12 13 5 11 12 12 12 12 12 12 13 5 5 5 11 12 12 12 15 19 14 13 5 11 12 12 12 12 15 26 21 21 21 21 21 21 21 21 21 
21 21 21 21 21 21 21 27 10 5 5 5 5 5 5 5 5 5 5 5 5 5 5 5 5 5 5 5 5 9 2 10 5 5 5 5 5 5 5 9 26 21 21 21 21 21 21 21 21 21 
21 21 21 21 21 21 21 27 10 5 5 5 5 5 5 5 5 5 5 5 5 5 5 5 5 5 5 5 5 9 2 10 5 5 5 5 5 5 5 9 26 21 21 21 21 21 21 21 21 21 
21 21 21 21 21 21 21 27 16 7 7 7 7 7 7 7 7 7 7 7 7 8 5 5 5 6 7 7 7 17 19 16 7 7 7 7 7 7 7 17 26 21 21 21 21 21 21 21 21 21 
21 21 21 21 21 21 21 27 19 19 19 19 19 19 19 19 19 19 19 19 2 10 5 5 5 9 2 19 19 19 19 19 19 19 19 19 19 19 19 19 26 21 21 21 21 21 21 21 21 21 
21 21 21 21 21 21 21 27 19 19 19 19 19 19 19 19 19 19 19 19 2 10 5 5 5 9 2 19 19 19 19 19 19 19 19 19 19 19 19 19 26 21 21 21 21 21 21 21 21 21 
21 21 21 21 21 21 21 27 19 19 19 19 19 19 19 19 19 19 19 19 2 10 5 5 5 9 2 19 19 19 19 19 19 19 19 19 19 19 19 19 26 21 21 21 21 21 21 21 21 21 
21 21 21 21 21 21 21 27 19 19 19 19 19 19 19 19 19 19 19 19 2 10 5 5 5 9 2 19 19 19 19 19 19 19 19 19 19 19 19 19 26 21 21 21 21 21 21 21 21 21 
21 21 21 21 21 21 21 27 19 19 19 19 19 19 19 19 19 19 19 19 2 10 5 5 5 9 2 19 19 19 19 19 19 19 19 19 19 19 19 19 26 21 21 21 21 21 21 21 21 21 
21 21 21 21 21 31 29 30 19 19 19 19 19 19 2 3 2 2 2 2 2 10 5 5 5 9 2 3 2 2 2 2 2 2 2 2 2 2 2 2 26 21 21 21 21 21 21 21 21 21 
21 21 21 31 29 30 2 2 19 19 19 19 19 19 2 2 2 2 4 2 3 10 5 5 5 9 3 4 2 3 4 2 2 2 2 2 2 2 2 2 26 21 21 21 21 21 21 21 21 21 
21 21 21 27 2 2 2 2 19 19 19 19 19 19 2 4 14 12 12 12 12 13 5 5 5 11 12 12 12 12 12 12 12 12 12 12 12 12 12 15 26 21 21 21 21 21 21 21 21 21 
21 21 21 27 2 2 2 2 19 19 19 19 19 19 3 2 10 5 5 5 5 5 5 5 5 5 5 5 5 5 5 5 5 5 5 5 5 5 5 9 26 21 21 21 21 21 21 21 21 21 
21 21 21 27 2 2 2 2 19 19 19 19 19 19 2 4 10 5 5 5 5 5 5 5 5 5 5 5 5 5 5 5 5 5 5 5 5 5 5 9 26 21 21 21 21 21 21 21 21 21 
21 21 21 27 2 2 2 2 19 19 19 19 19 19 2 2 10 5 5 6 7 7 7 7 7 7 7 8 5 5 6 7 7 7 7 7 7 7 7 17 26 21 21 21 21 21 21 21 21 21 
21 21 21 27 2 2 2 2 19 19 19 19 19 19 3 2 10 5 5 9 3 2 2 2 3 2 2 10 5 5 9 4 3 19 19 19 2 19 19 19 26 21 21 21 21 21 21 21 21 21 
21 21 21 27 2 2 2 2 19 19 19 19 19 19 2 4 10 5 5 9 23 24 24 24 24 24 25 10 5 5 9 2 2 19 19 2 2 2 19 19 26 21 21 21 21 21 21 21 21 21 
21 21 21 27 2 2 2 2 19 19 19 19 19 19 2 2 10 5 5 9 26 21 21 21 21 21 27 10 5 5 9 4 3 19 19 2 2 2 19 19 26 21 21 21 21 21 21 21 21 21 
21 21 21 33 24 24 25 2 19 19 19 19 19 19 2 2 10 5 5 9 26 21 21 21 21 21 27 10 5 5 9 2 2 19 19 2 2 2 19 19 26 21 21 21 21 21 21 21 21 21 
21 21 21 21 21 21 33 25 2 2 2 2 2 2 2 3 16 7 7 17 26 21 21 21 21 21 27 16 7 7 17 3 2 19 19 2 2 2 19 19 26 21 21 21 21 21 21 21 21 21 
21 21 21 21 21 21 21 27 2 2 23 24 24 24 25 2 2 2 2 2 26 21 21 21 21 21 27 19 2 2 19 2 2 19 19 19 19 19 19 19 26 21 21 21 21 21 21 21 21 21 
21 21 21 21 21 21 21 33 24 24 34 21 21 21 33 24 24 24 24 24 34 21 21 21 21 21 33 24 24 24 24 24 24 24 24 24 24 24 24 24 34 21 21 21 21 21 21 21 21 21 
21 21 21 21 21 21 21 21 21 21 21 21 21 21 21 21 21 21 21 21 21 21 21 21 21 21 21 21 21 21 21 21 21 21 21 21 21 21 21 21 21 21 21 21 21 21 21 21 21 21 
21 21 21 21 21 21 21 21 21 21 21 21 21 21 21 21 21 21 21 21 21 21 21 21 21 21 21 21 21 21 21 21 21 21 21 21 21 21 21 21 21 21 21 21 21 21 21 21 21 21 
21 21 21 21 21 21 21 21 21 21 21 21 21 21 21 21 21 21 21 21 21 21 21 21 21 21 21 21 21 21 21 21 21 21 21 21 21 21 21 21 21 21 21 21 21 21 21 21 21 21 
21 21 21 21 21 21 21 21 21 21 21 21 21 21 21 21 21 21 21 21 21 21 21 21 21 21 21 21 21 21 21 21 21 21 21 21 21 21 21 21 21 21 21 21 21 21 21 21 21 21 
21 21 21 21 21 21 21 21 21 21 21 21 21 21 21 21 21 21 21 21 21 21 21 21 21 21 21 21 21 21 21 21 21 21 21 21 21 21 21 21 21 21 21 21 21 21 21 21 21 21 
21 21 21 21 21 21 21 21 21 21 21 21 21 21 21 21 21 21 21 21 21 21 21 21 21 21 21 21 21 21 21 21 21 21 21 21 21 21 21 21 21 21 21 21 21 21 21 21 21 21 
